{
  "@": "",
  "/": " ",
  "ø": "o",
  "ˈ": "",
  "ˌ": "",
  "ː": "",
  "\n": " ",
  " ": " ",
  ",": ",",
  ".": ".",
  ";": ";",
  "a": "a",
  "b": "b",
  "d": "d",
  "e": "e",
  "f": "f",
  "h": "h",
  "x": "h",
  "i": "i",
  "j": "j",
  "k": "k",
  "kʰ": "k",
  "l": "l",
  "m": "m",
  "n": "n",
  "o": "o",
  "p": "p",
  "pʰ": "p",
  "s": "s",
  "sʰ": "s",
  "t": "t",
  "tʰ": "t",
  "ʈ": "t",
  "u": "u",
  "y": "u",
  "ɥ": "u",
  "ʏ": "u",
  "v": "v",
  "w": "w",
  "z": "z",
  "æ": "æ",
  "ð": "ð",
  "ŋ": "ŋ",
  "ɑ": "ɑ",
  "ɔ": "ɔ",
  "ə": "ə",
  "ɛ": "ɛ",
  "œ": "ɛ",
  "ɡ": "ɡ",
  "ɪ": "ɪ",
  "ɹ": "ɹ",
  "r": "ɹ",
  "ɻ": "ɹ",
  "ɹ̩": "ɹ̩",
  "ɚ": "ɹ̩",
  "ɝ": "ɹ̩",
  "ɾ": "ɹ̩",
  "ʃ": "ʃ",
  "ç": "ʃ",
  "ɕ": "ʃ",
  "ɕʰ": "ʃ",
  "ʂ": "ʃ",
  "ʂʰ": "ʃ",
  "ʊ": "ʊ",
  "ɤ": "ʊ",
  "ɨ": "ʊ",
  "ɯ": "ʊ",
  "ʌ": "ʌ",
  "ʒ": "ʒ",
  "ʐ": "ʒ",
  "θ": "θ"
}