{
  "!": "",
  "\"": "",
  "(": "",
  ")": "",
  ",": "",
  "-": "",
  ":": "",
  ";": "",
  "[": "",
  "]": "",
  " ": " ",
  ".": ".",
  "?": "?",
  "_": "_",
  "a": "a",
  "æ": "a",
  "e": "e",
  "f": "f",
  "i": "i",
  "j": "j",
  "k": "k",
  "ɡ": "k",
  "l": "l",
  "m": "m",
  "n": "n",
  "o": "o",
  "p": "p",
  "b": "p",
  "s": "s",
  "ð": "s",
  "θ": "s",
  "t": "t",
  "d": "t",
  "u": "u",
  "w": "w",
  "v": "w",
  "h": "x",
  "~": "~",
  "ŋ": "ŋ",
  "ɑ": "ɑ",
  "ʌ": "ɑ",
  "ɔ": "ɔ",
  "z": "ɕ",
  "ʒ": "ɕ",
  "ə": "ə",
  "ɛ": "ɛ",
  "ɪ": "ɪ",
  "ɹ": "ɻ",
  "ɹ̩": "ɻ",
  "ʃ": "ʂ",
  "ʊ": "ʊ"
}